
########################################
###########...............&............<
###########.............................
###########.............................
########################................
##############.....&...#................
##############.........#................
>............#.........#......##########
.............#.........#......#..&....##
###########..#.........#......#.......##
###########..#####+#####......+.......##
###########...................#.......##
###########...................##########
############+##############+############
############.##########.&.......########
########.....##########.........########
###..&.......##########.........########
###..........##########.........########
###.....###############.........########
########################################
########################################
###########...&......#....&............<
###########..........+..................
###########....#######........##########
########################......#........#
##############.....&...#......+.......&#
##############.........#......#........#
>............#.........#......##########
.............#.........#......#..&....##
###########..#.........#......#.......##
###########..#####+#####......+.......##
##.&..#####...................#.......##
##....#####...................##########
##....######+##############+############
###..#######.##########.&.......########
###..###.....##########.........########
###..&.......##########........&########
###..........##########.........########
###.....###############.&.......########
########################################
########################################
#############....&&......&&..#.........<
#############................#.........#
#############................#.........#
###################+##########.........#
######.................................#
######.................................#
>........############...############...#
.........#....#.....#...#....#.....#...#
######...+....#&....+...+....#&....+...#
#..&.#...#..&.#.....#...#..&.#.....#...#
#&...+...############...############...#
#....#...#...&#..&..#...#...&#..&..#...#
######...+....#.....+...+....#.....+...#
#..&.#...#....#..&..#...#....#..&..#...#
#&...#...############...############...#
#....#...######&....#...#...&#..&..#...#
###############.....+...+....#.....+...#
###############&....#...#..&.#.....#...#
########################################
